[
    {
        "spawn": [5, 4],
        "tiles": [
            [1, 1, 1, 1, 1, 1, 1, 1, 1, 1],
            [2, 2, 2, 2, 2, 2, 2, 2, 2, 2],
            [0, 0, 0, 0, 0, 0, 0, 0, 0, 0],
            [0, 5, 5, 5, 0, 0, 0, 0, 0, 0],
            [0, 5, 5, 5, 0, 0, 0, 0, 0, 0],
            [0, 5, 5, 5, 0, 0, 0, 0, 0, 0],
            [0, 0, 0, 0, 0, 0, 0, 0, 0, 0],
            [0, 0, 0, 0, 0, 0, 0, 0, 0, 0],
            [1, 1, 1, 1, 3, 4, 1, 1, 1, 1],
            [1, 1, 1, 1, 3, 4, 1, 1, 1, 1],
            [2, 2, 2, 2, 3, 4, 2, 2, 2, 2],
            [0, 0, 0, 0, 0, 0, 0, 0, 0, 0],
            [0, 0, 0, 0, 0, 0, 0, 0, 0, 0],
            [0, 0, 0, 0, 0, 0, 0, 0, 0, 0],
            [0, 0, 0, 0, 0, 0, 0, 0, 0, 0],
            [0, 0, 0, 0, 0, 0, 0, 0, 0, 0],
            [1, 1, 1, 1, 1, 1, 1, 1, 1, 1]
        ]
    },
    {
        "spawn": [5, 8],
        "tiles": [
            [0, 0, 0, 0, 0, 0, 0, 0, 0, 0],
            [0, 0, 0, 0, 0, 0, 0, 0, 0, 0],
            [0, 0, 0, 0, 0, 0, 0, 0, 0, 0],
            [0, 0, 0, 0, 0, 0, 0, 0, 0, 0],
            [0, 0, 0, 0, 0, 0, 0, 0, 0, 0],
            [0, 0, 0, 0, 0, 0, 0, 0, 0, 0],
            [0, 0, 0, 0, 0, 0, 0, 0, 0, 0],
            [0, 0, 0, 0, 0, 0, 0, 0, 0, 0],
            [0, 0, 0, 0, 0, 0, 0, 0, 0, 0],
            [0, 0, 0, 0, 0, 0, 0, 0, 0, 0]
        ]
    }
]